##############
#cccccccccccc#
#c####c#####c#
#p#--#c#---#c#
#c####c#####c#
#ccccccccccccc
#c####c##c####
#c####c##c####
#cccccc##cccc#
######c#####-#
-----#c#####-#
-----#c##-----
-----#c##-####
######c##-#---
------c---#---
######c##-#---
-----#c##-####
-----#c##-----
-----#c##-####
######c##-####
#cccccccccccc#
#c####c#####c#
#c####c#####c#
#pcc##ccccccc-
###c##c##c####
###c##c##c####
#cccccc##cccc#
#c##########c#
#c##########c#
#ccccccccccccc
##############